11111111111111111111111111111
10000000000000000000000000001
10100000000010000001000000001
10000000W00000000000000000001
10000000000010000001000000001
10000000000000000000000000001
11111111111111111111111111111



11111111111111111111111111111
10000000000000000000000000001
10100000000010000001000000001
10000000000000000000000000001
10000000000010000001000000001
10000000000000000000000000001
11111111111111111111111111111
