111111111111111
100000000000101
100000W00000101
100000000000001
111111111111111
