11111
10101
10W01
10001
11111
