11111111111111111
10000000000000000
10000001110000000
10000001W10000000
1000000111000001
10000000000000001
11111111111111111
