11111111111111111
10000000000000000
10000011111100000
10000010W00100000
10000011111100001
10000000000000001
11111111111111111
