NO ./textures/colorstone.xpm
SO ./textures/greystone.xpm
WE ./textures/redbrick.xpm
EA ./textures/wood.xpm

F 139,69,19
C 30,144,255


        1111111111111111111111111

        1000000000000000000000001
        1000000000000000000000001
        1000000000000000000000001
111011111000000000000000000000001
100000000000001000000000000001111
10000000000001N0000000000001
10000000000000100000000000001
1000000000000000000000000001
10000000000000000000000000001
10000000000000000001010000001
11000001110101011111011110101
11110111 1110111 101111010001
11111111 1111111 11111111111
