NO ./textures/colorstone.xpm



SO ./textures/greystone.xpm

WE ./textures/redbrick.xpm




EA ./textures/wood.xpm



F 148,109,80
C 117,217,247



11111111111111111111111111111
10000000000000000000000000001
10100000000010000001000000001
10000000W00000000000000000001
10000000000010000001000000001
10000000000000000000000000001
11110011111111111111111111111
1000000000001
1000000000001
1000000000001
1000000000001
11111000111111111111111111111
10000000000000000000000000001
10100000000010000001000000001
10000000000000000000000000001
10000000000010000001000000001
10000000000000000000000000001
11111111111111111111111111111
